R 1800 700
S 255,150,75


11111111
11000001
11000001
11000001
11000001
11111111
