R  1024 720
C  255,150,75
F  250,150,75

NO	./textures/south.xpm
SO	./textures/north.xpm
WE	./textures/east.xpm
EA	./textures/west.xpm
S	./textures/sprite.xpm

1111
11111111111111111
10000000000000001111111111111
111111110111020010020000020111
111111111111111111111111111111
11
111111111111111111111111111111111111111
111111111111100000000000000111111
1000200020002000111111111111111111111111111111111111111111111111111
10000000000000001
10202021111120201
1E0000001  100001
10002001111100001
10000000000000001
10200000200002001
10000000000000001
11111111111111111
