R  1805   700
С 255,150,75

          111111111
   1000000000000001
   1000000000000001
   1000000000000001
   1000000000000001
   1000000000000001
   1000000000000001
   1000000011111111
   11111111
