R  1024 720
C  255,150,75
F  250,150,75

NO	./textures/south.xpm
SO	./textures/north.xpm
WE	./textures/east.xpm
EA	./textures/west.xpm
S	./textures/sprite.xpm

1111
11111111111111111
10000000000000001111111111111
111111110111020010020000020111
111111111111111111111111111111
11
111111111111111111111111111111111111111
111111111111100000000000000111111
1000200020002000111111111111111111111111111111111111111111111111111
100000011000000011
10202021111120201
100W0000100000001
10002001101000001
10000000001100001
10200000200002001
10000110000000001
11111111111111111
