R  1805   700
C  255,	150,75
F  255,	250,100

NO	./textures/north.xpm
SO	./textures/sout
WE	./textures/west.xpm
EA	./textures/east.xpm


111111111111111111111111111111111111111111111111111111111111
110000000111000000000000000000000000000000000000000000000001
110000000111000000000000011111000000000001111111111000000001
110000000000000000000000011111000000000001111111111000000001
110000001111111111000000000000000000000001111111111000000001
110000001111111111000000000000000000000001111111111000000001
110000000000000000000000000000000000000000000000000000000001
11000000000000000000000000110000000000000N000000000000000001
110000000000000000000000001100000000000000000000000000000001
110000000000000000000000000000000000000011000000000000000001
110011111001100000011000000000000000000011000000000001111111
110011111000000000011000000000000000000000000000000001111111
110011111000000000000000000000011100000000000000000000000001
110011110000000000000000000000011100000000000000000000000001
111111111111111111111111111111111111111111111111111111111111


