  R  1805   700
  C 255    ,      150,75
  F    350,250,100
   NO   ./textures/here_we_go
   SO	./there_we_go
   WE	./then_we_go
   EA	./why_we_go


          111111111
   1000000000000001
   1000000000000001
   1000000000000001
   1000000000000001
   1000000000000001
   1000000000000001
   1000000011111111
   11111111
