  R  1800 700 300
S 255,150,75


          111111111
   1000000000000001
   1000000000000001
   1000000000000001
   1000000000000001
   1000000000000001
   1000000000000001
   1000000011111111
   11111111
