  R  1805   700
  C			 255  ,      150  ,   75
 	 F    350,250,100

   NO   ./textures/north
   SO	./textures/south
   WE	./textures/west
   EA	./textures/east


          111111111
   1000000000000001
   1000000000000001
   1000000000000001
   1000000000000001
   1000000000000001
   1000000000000001
   1000000011111111
   11111111
