R  1980 1080
C  255,150,75
F  255, 150,75

NO	./textures/north.xpm
SO	./textures/sout
WE	./textures/west.xpm
EA	./textures/east.xpm


111111111111111111111111
100000000000000000000001
100000000000000000000001
100000000000000000000001
100000111110000000000001
100000100010000000000001
100000100010000000000001
100000100010000000000001
100000110110000000000001
100000000000000000000001
100000000000000000000001
1000000000000N0000000001
100000000000000000000001
100000000000000000000001
100000000000000000000001
100000000000000000000001
100000000000000000000001
100000000000000000000001
100000000000000000000001
100000000000000000000001
100000000000000000000001
100000000000000000000001
100000000000000000000001
111111111111111111111111


