R  1805   700
C			 255  ,      150  ,   75
F    350,250,100

NO   ./textures/north
SO	./textures/south
WE	./textures/west
EA	./textures/east


111111111111111111111111111111
100000000000011100000000000001
10000W000000011100000000000001
100000000000000000000000000001
100110000000011110000011111001
100110000000011110000011111001
100000000000011110000011111001
100000011111111111111111111111
11111111
