R  1024 720
C  255,150,75
F  250,150,75

NO	./textures/north.xpm
SO	./textures/south.xpm
WE	./textures/west.xpm
EA	./textures/east.xpm
S	./textures/sprite.xpm

1111111111111111111111111111111
10000000001100000000000001
00110000011100000020000001
10010000000000000000000001
11111111101100000111000001
10000000001100000111011111
11110111111111011100000011
11110111111111011101010011
110N0000110101011100000011
10002000000000001100000011
10000000000000001101010011
11000001000101011111011111
11111111111111111111111111
