R  1980 1080
C  255,150,75
F  255, 150,75

NO	./textures/north.xpm
SO	./textures/sout
WE	./textures/west.xpm
EA	./textures/east.xpm


111111111111111111111111111
100000000000000000000000001
100000000000000000000000001
100000000000000000000000001
100000111110000000000000001
100000100010000000000000001
100000100010000000000000001
100000100010000000000000001
100000110110000000000000001
100000000000000000000000001
100000000000000011000000001
100000002222220000000000001
100000002222220000000000001
100000000000000000000000001
100000000000011111000000001
100000000000011111000000001
1000000000S0000000000000001
100000000000000000000000001
100000000000000000000000001
100000000000000000000000001
100000000000000000000000001
100000000000000000000000001
111111111111111111111111111

