R     1024    720
C     125,33,44

F     105,45,70




NO     ./textures/kim.xpm
SO       ./textures/lenin.xpm


WE ./textures/soviet.xpm
EA ./textures/flag.xpm
S   ./textures/kgb.xpm


1111
11111111111111111
1000000000000000111111111111
111111110111020010020000020111
111111111111111111111111111111
11
111111111111111111111111111111111111111
111111111111100000000000000111111
1000200020002000111111111111111111111111111111111111111111111111111
100000011000000011
10202021111120201
10000000100000001
10002001101000001
10000000001100001
10200W00200002001
100001100000000011111111
111111111111111111111
